20
11
====================
=....=........=....=
=.==.=.======.=.==.=
=.=..............=.=
=.=.==.==..==.==.=.=
=......=....=......=    
=.=.==.======.==.=.=
=.=.......P......=.=
=.==.=.======.=.==.=
=....=........=....=
====================
