20
11
====================
=....=........=....=
=.==.=.======.=.==.=
=.=..............=.=
=.=.==.==..==.==.=.=
=......=R..Y=......=    
=.=.==.======.==.=.=
=.=.......P......=.=
=.==.=.======.=.==.=
=....=........=....=
====================
