11
11
===========
=....=....=
=.==.=.==.=
=.=.....=.=
=.=.===.=.=
=.........=
=.=.===.=.=
=.=.....=.=
=.==.=.==.=
=....=....=
===========